,Squad,# Pl,90s,Tkl,TklW,Def 3rd,Mid 3rd,Att 3rd,Tkl.1,Att,Tkl%,Lost,Blocks,Sh,Pass,Int,Tkl+Int,Clr,Err,season
0,Arsenal,28,38.0,609,366,294,236,79,228,535,42.6,307,424,118,306,412,1021,798,28,2018_19
1,Bournemouth,28,38.0,525,299,285,185,55,216,494,43.7,278,405,152,253,371,896,1098,21,2018_19
2,Brighton,21,38.0,679,391,363,238,78,264,582,45.4,318,415,170,245,463,1142,1001,17,2018_19
3,Burnley,23,38.0,584,311,280,246,58,237,539,44.0,302,516,222,294,367,951,1156,19,2018_19
4,Cardiff City,25,38.0,655,375,357,234,64,241,607,39.7,366,490,147,343,529,1184,1034,18,2018_19
5,Chelsea,24,38.0,618,365,280,245,93,241,541,44.5,300,357,73,284,353,971,645,16,2018_19
6,Crystal Palace,26,38.0,733,446,398,270,65,281,590,47.6,309,441,141,300,445,1178,1011,17,2018_19
7,Everton,23,38.0,699,441,326,290,83,220,511,43.1,291,414,85,329,453,1152,877,21,2018_19
8,Fulham,28,38.0,596,362,310,231,55,224,524,42.7,300,425,144,281,434,1030,1030,28,2018_19
9,Huddersfield,31,38.0,708,425,323,315,70,263,625,42.1,362,496,130,366,531,1239,682,15,2018_19
10,Leicester City,25,38.0,675,393,344,277,54,237,549,43.2,312,429,96,333,438,1113,1034,24,2018_19
11,Liverpool,23,38.0,613,377,257,280,76,251,556,45.1,305,361,78,283,314,927,670,16,2018_19
12,Manchester City,21,38.0,518,327,214,215,89,193,467,41.3,274,319,63,256,362,880,570,15,2018_19
13,Manchester Utd,28,38.0,581,347,280,239,62,240,544,44.1,304,445,128,317,355,936,847,26,2018_19
14,Newcastle Utd,24,38.0,711,433,356,291,64,241,565,42.7,324,472,135,337,506,1217,1204,16,2018_19
15,Southampton,30,38.0,698,428,335,283,80,277,646,42.9,369,533,153,380,549,1247,1128,18,2018_19
16,Tottenham,28,38.0,627,373,310,237,80,268,577,46.4,309,415,112,303,325,952,823,20,2018_19
17,Watford,25,38.0,656,391,350,243,63,257,622,41.3,365,404,120,284,428,1084,1022,18,2018_19
18,West Ham,26,38.0,723,393,385,279,59,295,697,42.3,402,488,142,346,457,1180,926,16,2018_19
19,Wolves,21,38.0,720,408,385,284,51,283,664,42.6,381,499,148,351,501,1221,895,23,2018_19
20,Arsenal,29,38.0,584,336,296,217,71,249,612,40.7,363,398,141,257,351,935,754,18,2019_20
21,Aston Villa,28,38.0,523,291,285,174,64,223,597,37.4,374,456,184,272,423,946,928,26,2019_20
22,Bournemouth,27,38.0,507,299,254,206,47,207,567,36.5,360,439,160,279,475,982,1008,16,2019_20
23,Brighton,25,38.0,641,379,295,269,77,245,642,38.2,397,437,137,300,419,1060,750,15,2019_20
24,Burnley,22,38.0,547,344,238,241,68,240,585,41.0,345,450,175,275,387,934,901,15,2019_20
25,Chelsea,27,38.0,638,362,304,258,76,246,604,40.7,358,361,91,270,459,1097,631,14,2019_20
26,Crystal Palace,25,38.0,686,390,367,244,75,316,711,44.4,395,399,135,264,444,1130,856,18,2019_20
27,Everton,24,38.0,671,408,328,262,81,282,672,42.0,390,372,111,261,408,1079,778,13,2019_20
28,Leicester City,24,38.0,742,432,347,320,75,298,725,41.1,427,420,92,328,423,1165,767,16,2019_20
29,Liverpool,24,38.0,550,325,195,243,112,217,588,36.9,371,302,68,234,352,902,634,25,2019_20
30,Manchester City,24,38.0,514,301,204,210,100,230,605,38.0,375,292,66,226,352,866,495,21,2019_20
31,Manchester Utd,29,38.0,579,333,267,231,81,254,634,40.1,380,360,99,261,379,958,703,14,2019_20
32,Newcastle Utd,28,38.0,603,357,364,198,41,273,632,43.2,359,402,152,250,391,994,988,19,2019_20
33,Norwich City,30,38.0,628,379,359,210,59,267,700,38.1,433,453,171,282,397,1025,959,20,2019_20
34,Sheffield Utd,26,38.0,611,377,304,229,78,261,646,40.4,385,336,106,230,420,1031,931,16,2019_20
35,Southampton,25,38.0,706,416,325,287,94,324,793,40.9,469,488,124,364,425,1131,867,21,2019_20
36,Tottenham,29,38.0,665,415,331,281,53,253,681,37.2,428,441,148,293,381,1046,894,24,2019_20
37,Watford,26,38.0,657,369,347,249,61,267,713,37.4,446,396,135,261,424,1081,869,4,2019_20
38,West Ham,29,38.0,696,417,374,263,59,300,745,40.3,445,383,117,266,421,1117,789,16,2019_20
39,Wolves,21,38.0,646,367,358,227,61,281,685,41.0,404,378,109,269,437,1083,702,23,2019_20
40,Arsenal,29,38.0,456,252,206,184,66,212,547,38.8,335,368,113,255,351,807,643,16,2020_21
41,Aston Villa,24,38.0,530,282,262,202,66,250,571,43.8,321,438,159,279,387,917,783,17,2020_21
42,Brighton,27,38.0,628,334,297,251,80,252,603,41.8,351,417,97,320,425,1053,604,8,2020_21
43,Burnley,25,38.0,507,293,241,203,63,229,564,40.6,335,440,180,260,416,923,824,11,2020_21
44,Chelsea,27,38.0,612,341,257,282,73,231,570,40.5,339,420,83,337,382,994,661,16,2020_21
45,Crystal Palace,24,38.0,636,366,329,234,73,283,620,45.6,337,447,138,309,396,1032,774,13,2020_21
46,Everton,29,38.0,640,381,325,242,73,266,664,40.1,398,458,157,301,392,1032,847,19,2020_21
47,Fulham,28,38.0,601,329,282,231,88,254,581,43.7,327,356,95,261,437,1038,794,13,2020_21
48,Leeds United,23,38.0,740,417,378,279,83,310,769,40.3,459,406,149,257,397,1137,646,26,2020_21
49,Leicester City,27,38.0,681,403,319,263,99,295,676,43.6,381,386,90,296,438,1119,685,9,2020_21
50,Liverpool,28,38.0,526,303,195,231,100,220,543,40.5,323,338,58,280,347,873,563,20,2020_21
51,Manchester City,24,38.0,498,271,198,212,88,234,576,40.6,342,310,82,228,319,817,453,11,2020_21
52,Manchester Utd,29,38.0,551,311,252,239,60,231,572,40.4,341,418,116,302,386,937,634,20,2020_21
53,Newcastle Utd,27,38.0,512,268,257,213,42,207,547,37.8,340,423,160,263,362,874,908,10,2020_21
54,Sheffield Utd,27,38.0,634,356,325,239,70,294,720,40.8,426,442,152,290,351,985,839,19,2020_21
55,Southampton,29,38.0,727,419,335,325,67,341,731,46.6,390,439,95,344,401,1128,681,10,2020_21
56,Tottenham,24,38.0,636,361,313,244,79,277,683,40.6,406,434,147,287,342,978,795,15,2020_21
57,West Brom,30,38.0,581,328,329,192,60,271,656,41.3,385,455,159,296,435,1016,876,13,2020_21
58,West Ham,24,38.0,514,280,269,195,50,224,573,39.1,349,405,124,281,437,951,779,11,2020_21
59,Wolves,27,38.0,588,335,322,220,46,277,611,45.3,334,359,117,242,432,1020,727,15,2020_21
60,Arsenal,27,38.0,540,311,261,195,84,244,500,48.8,256,386,123,263,296,836,658,20,2021_22
61,Aston Villa,31,38.0,634,382,300,259,75,300,649,46.2,349,453,140,313,339,973,693,13,2021_22
62,Brentford,29,38.0,607,342,299,228,80,291,616,47.2,325,383,113,270,393,1000,863,7,2021_22
63,Brighton,26,38.0,668,403,306,257,105,243,563,43.2,320,480,150,330,358,1026,723,12,2021_22
64,Burnley,23,38.0,590,324,273,235,82,250,534,46.8,284,509,211,298,410,1000,887,18,2021_22
65,Chelsea,26,38.0,621,348,267,269,85,257,567,45.3,310,408,96,312,347,968,641,15,2021_22
66,Crystal Palace,24,38.0,637,374,323,236,78,273,575,47.5,302,452,135,317,333,970,761,5,2021_22
67,Everton,33,38.0,705,402,369,252,84,336,735,45.7,399,496,140,356,365,1070,815,15,2021_22
68,Leeds United,29,38.0,787,437,396,298,93,408,886,46.0,478,473,143,330,395,1182,621,15,2021_22
69,Leicester City,28,38.0,690,384,336,270,84,306,720,42.5,414,469,146,323,367,1057,777,15,2021_22
70,Liverpool,27,38.0,554,320,207,240,107,233,576,40.5,343,359,74,285,340,894,523,8,2021_22
71,Manchester City,26,38.0,498,284,183,214,101,227,509,44.6,282,267,55,212,279,777,403,7,2021_22
72,Manchester Utd,29,38.0,585,358,320,197,68,265,608,43.6,343,404,133,271,340,925,704,20,2021_22
73,Newcastle Utd,29,38.0,659,383,334,266,59,304,641,47.4,337,420,162,258,360,1019,776,14,2021_22
74,Norwich City,28,38.0,614,368,322,242,50,297,714,41.6,417,450,180,270,381,995,860,14,2021_22
75,Southampton,25,38.0,602,340,285,243,74,248,581,42.7,333,430,132,298,446,1048,795,13,2021_22
76,Tottenham,25,38.0,598,349,286,244,68,262,584,44.9,322,470,161,309,355,953,793,15,2021_22
77,Watford,30,38.0,614,356,341,213,60,278,626,44.4,348,440,148,292,444,1058,899,19,2021_22
78,West Ham,25,38.0,534,301,273,199,62,240,557,43.1,317,420,175,245,374,908,781,5,2021_22
79,Wolves,26,38.0,673,377,377,242,54,273,671,40.7,398,437,135,302,389,1062,820,20,2021_22
80,Arsenal,26,38.0,568,343,238,212,118,249,509,48.9,260,362,86,276,237,805,599,23,2022_23
81,Aston Villa,26,38.0,633,338,305,251,77,313,646,48.5,333,438,118,320,324,957,714,14,2022_23
82,Bournemouth,31,38.0,618,371,316,249,53,256,606,42.2,350,499,170,329,353,971,1027,11,2022_23
83,Brentford,25,38.0,587,337,270,228,89,253,599,42.2,346,456,168,288,341,928,822,14,2022_23
84,Brighton,29,38.0,616,340,270,242,104,266,561,47.4,295,392,104,288,303,919,432,15,2022_23
85,Chelsea,32,38.0,740,445,363,267,110,333,656,50.8,323,466,108,358,341,1081,661,21,2022_23
86,Crystal Palace,26,38.0,690,421,354,246,90,281,532,52.8,251,463,119,344,359,1049,807,7,2022_23
87,Everton,28,38.0,708,424,362,257,89,309,611,50.6,302,510,180,330,390,1098,874,17,2022_23
88,Fulham,29,38.0,625,350,295,229,101,299,585,51.1,286,455,125,330,340,965,749,15,2022_23
89,Leeds United,29,38.0,840,480,376,343,121,412,863,47.7,451,536,131,405,392,1232,734,18,2022_23
90,Leicester City,28,38.0,700,412,345,292,63,308,669,46.0,361,517,170,347,367,1067,777,12,2022_23
91,Liverpool,28,38.0,590,370,228,250,112,281,648,43.4,367,350,74,276,333,923,568,20,2022_23
92,Manchester City,24,38.0,471,272,185,198,88,212,462,45.9,250,339,95,244,223,694,402,9,2022_23
93,Manchester Utd,26,38.0,658,400,343,231,84,301,598,50.3,297,496,146,350,352,1010,771,11,2022_23
94,Newcastle Utd,27,38.0,607,360,268,254,85,307,642,47.8,335,448,116,332,333,940,680,10,2022_23
95,Nott'ham Forest,33,38.0,659,387,380,201,78,296,584,50.7,288,500,156,344,349,1008,944,7,2022_23
96,Southampton,36,38.0,713,426,377,279,57,297,611,48.6,314,542,165,377,428,1141,852,11,2022_23
97,Tottenham,29,38.0,619,353,325,215,79,275,574,47.9,299,428,148,280,340,959,762,20,2022_23
98,West Ham,25,38.0,608,336,290,226,92,270,562,48.0,292,415,139,276,408,1016,810,10,2022_23
99,Wolves,32,38.0,661,370,364,222,75,286,609,47.0,323,497,175,322,279,940,817,19,2022_23
